0000000000000000000000
00XXXXXX00000000XXXX00
0000000000XXXXX0000000
0000000000000000000000
0000000XX0000000000000
0000000000000000000000
00000XXXXXXXX000000000
0000000000000000XX0000
0000000000000000000000
00000000000000XX000000
0000000000000000000000
00000000XXXXX000000000
0000000000000000000000
XXXXXXXXXXXXXXXXXXXXXX
